t t t t t t t t t t t t t t t t t t t t
t c n n n n n n n n n n n n n n n n n t
t n n n n n n n n n n n n n n w n w n t
t n n n n n n n n n n n n n n n c n n t
t n n n n n n n n n n n n n n w n w n t
t n n n n n n n n n n n n n n n n n n t
t n n n n n n w n n t n n n n n n n n t
t t t n n n n n n n t n n n n n n n n t
t n n n n n n n n n t n n n n n n n n t
t n n n n n n n n t t n n n n n n n n t
t n n n n n n n n n n n n n n n n n n t
t n n n n n n n n n n n n n n n n n n t
t n n n n n n n n n n n n n n n n n n t
t n n n n n n w n n n n n n n n n n n t
t n n n n n n n n n n n n n n n n n n t
t n n n n n n n n n n n n n n n n n n t
t n n n n n n n n n n n n n n n n n n t
t n n n n n n t t t t n n n n n n n n t
t n n n n n n w n t t t n n n n n n n t
t n n n n n n w n c n n n n n n n n n t
t n n n n n n t t t t t n n n n n n n t
t n n n n n n n n n n n n n n n n n n t
t n n n n n n n n n n n n n n n n n n t
t n n n n n n n n n n n n n n n n n n t
t n n n n n n n n n n n n n n n n n n t
t n n n n t n n n n n n n n n n n n w t
t t t t t t t t t t t t t t t t t t t t